6 0 0 5
211111111122222222222
100000000012222222222
100000000012222222222
100000000012222222222
100000000012222222222
100000000012222222222
100000000012222222222
100034400012222222222
100000000012222222222
100000000012222222222
111111111121111111112
100000000010000000001
100000000010000000001
100000000010000000001
100000000010000000001
100000000010000000001
100000000010000000001
100000000010000000001
100000000010000000001
100000000010000000001
211111111111111111112