7 4 0 3
211111111111111111112
100000000010000000001
100000000010000000001
100000000010000000001
100000000010000000001
100000000010000000001
100000000010000000001
100034400010000000001
100000000010000000001
100000000010000000001
111111111121111111111
100000000010000000001
100000000010000000001
100000000010000000001
100000000010000000001
100000000010000000001
100000000010000000001
100000000010000000001
100000000010000000001
100000000010000000001
211111111111111111112