12 7 4 5
211111111111111222222
100000000000000122222
100000000000000122222
100000000000000122222
100000010000000122222
100000010000000122222
100000010000000122222
100000010000000111112
100000010000000000001
100000010000000000001
100000000000000000001
100000000000000000001
100000003440000000001
100000000000000000001
100000000000000000001
100000011111110000001
100000000000000000001
100000000000000000001
100000000000000000001
100000000000000000001
211111111111111111112