7 6 2 1
211111111121111111112
100000000010000000001
100000000010000000001
100000000010000000001
100000000000000000001
100000000000000000001
100000000000000000001
100034400010000000001
100000000010000000001
100000000010000000001
211100011121110001112
100000000010000000001
100000000010000000001
100000000000000000001
100000000000000000001
100000000000000000001
100000000010000000001
100000000010000000001
100000000010000000001
100000000010000000001
211111111121111111112